"filename", "language", "JavaScript", "comment", "blank", "total"
"/Users/hayleycloud/Downloads/Aegis/src/assets/utils/TriviaPlayer.js", "JavaScript", 257, 13, 29, 299
"/Users/hayleycloud/Downloads/Aegis/src/assets/utils/forhumans.js", "JavaScript", 24, 0, 3, 27
"/Users/hayleycloud/Downloads/Aegis/src/assets/utils/static.js", "JavaScript", 10, 0, 1, 11
"/Users/hayleycloud/Downloads/Aegis/src/bot.js", "JavaScript", 202, 8, 17, 227
"/Users/hayleycloud/Downloads/Aegis/src/commands/afk/list.js", "JavaScript", 11, 0, 7, 18
"/Users/hayleycloud/Downloads/Aegis/src/commands/afk/set.js", "JavaScript", 30, 0, 8, 38
"/Users/hayleycloud/Downloads/Aegis/src/commands/announcement/create.js", "JavaScript", 19, 0, 5, 24
"/Users/hayleycloud/Downloads/Aegis/src/commands/announcement/edit.js", "JavaScript", 15, 0, 6, 21
"/Users/hayleycloud/Downloads/Aegis/src/commands/automod/add.js", "JavaScript", 34, 0, 6, 40
"/Users/hayleycloud/Downloads/Aegis/src/commands/automod/antiinvite.js", "JavaScript", 20, 0, 6, 26
"/Users/hayleycloud/Downloads/Aegis/src/commands/automod/antilinks.js", "JavaScript", 20, 0, 6, 26
"/Users/hayleycloud/Downloads/Aegis/src/commands/automod/antispam.js", "JavaScript", 20, 0, 6, 26
"/Users/hayleycloud/Downloads/Aegis/src/commands/automod/display.js", "JavaScript", 19, 0, 4, 23
"/Users/hayleycloud/Downloads/Aegis/src/commands/automod/linkschannel.js", "JavaScript", 69, 0, 11, 80
"/Users/hayleycloud/Downloads/Aegis/src/commands/automod/remove.js", "JavaScript", 36, 0, 8, 44
"/Users/hayleycloud/Downloads/Aegis/src/commands/autosetup/customvoice.js", "JavaScript", 47, 0, 5, 52
"/Users/hayleycloud/Downloads/Aegis/src/commands/autosetup/fun.js", "JavaScript", 49, 0, 9, 58
"/Users/hayleycloud/Downloads/Aegis/src/commands/autosetup/games.js", "JavaScript", 60, 0, 12, 72
"/Users/hayleycloud/Downloads/Aegis/src/commands/autosetup/logs.js", "JavaScript", 37, 0, 7, 44
"/Users/hayleycloud/Downloads/Aegis/src/commands/autosetup/ticketpanel.js", "JavaScript", 31, 0, 7, 38
"/Users/hayleycloud/Downloads/Aegis/src/commands/autosetup/welcome.js", "JavaScript", 31, 0, 7, 38
"/Users/hayleycloud/Downloads/Aegis/src/commands/birthdays/check.js", "JavaScript", 15, 0, 5, 20
"/Users/hayleycloud/Downloads/Aegis/src/commands/birthdays/delete.js", "JavaScript", 16, 0, 5, 21
"/Users/hayleycloud/Downloads/Aegis/src/commands/birthdays/list.js", "JavaScript", 11, 0, 7, 18
"/Users/hayleycloud/Downloads/Aegis/src/commands/birthdays/set.js", "JavaScript", 62, 0, 13, 75
"/Users/hayleycloud/Downloads/Aegis/src/commands/bot/changelogs.js", "JavaScript", 15, 0, 4, 19
"/Users/hayleycloud/Downloads/Aegis/src/commands/bot/donate.js", "JavaScript", 18, 0, 4, 22
"/Users/hayleycloud/Downloads/Aegis/src/commands/bot/feedback.js", "JavaScript", 23, 0, 6, 29
"/Users/hayleycloud/Downloads/Aegis/src/commands/bot/info.js", "JavaScript", 136, 0, 7, 143
"/Users/hayleycloud/Downloads/Aegis/src/commands/bot/links.js", "JavaScript", 42, 0, 4, 46
"/Users/hayleycloud/Downloads/Aegis/src/commands/bot/owner.js", "JavaScript", 29, 0, 3, 32
"/Users/hayleycloud/Downloads/Aegis/src/commands/bot/ping.js", "JavaScript", 37, 0, 6, 43
"/Users/hayleycloud/Downloads/Aegis/src/commands/bot/support.js", "JavaScript", 18, 0, 4, 22
"/Users/hayleycloud/Downloads/Aegis/src/commands/bot/uptime.js", "JavaScript", 24, 0, 4, 28
"/Users/hayleycloud/Downloads/Aegis/src/commands/bot/vote.js", "JavaScript", 36, 0, 5, 41
"/Users/hayleycloud/Downloads/Aegis/src/commands/config/leavemessage.js", "JavaScript", 66, 0, 12, 78
"/Users/hayleycloud/Downloads/Aegis/src/commands/config/levelmessage.js", "JavaScript", 60, 0, 10, 70
"/Users/hayleycloud/Downloads/Aegis/src/commands/config/levels.js", "JavaScript", 25, 0, 8, 33
"/Users/hayleycloud/Downloads/Aegis/src/commands/config/setchannelname.js", "JavaScript", 42, 0, 9, 51
"/Users/hayleycloud/Downloads/Aegis/src/commands/config/setcolor.js", "JavaScript", 49, 0, 11, 60
"/Users/hayleycloud/Downloads/Aegis/src/commands/config/setverify.js", "JavaScript", 55, 0, 10, 65
"/Users/hayleycloud/Downloads/Aegis/src/commands/config/ticketmessage.js", "JavaScript", 131, 0, 17, 148
"/Users/hayleycloud/Downloads/Aegis/src/commands/config/welcomemessage.js", "JavaScript", 66, 0, 12, 78
"/Users/hayleycloud/Downloads/Aegis/src/commands/custom-commands/add.js", "JavaScript", 103, 0, 14, 117
"/Users/hayleycloud/Downloads/Aegis/src/commands/custom-commands/delete.js", "JavaScript", 28, 0, 5, 33
"/Users/hayleycloud/Downloads/Aegis/src/commands/developers/args.js", "JavaScript", 249, 0, 21, 270
"/Users/hayleycloud/Downloads/Aegis/src/commands/developers/badge.js", "JavaScript", 124, 0, 21, 145
"/Users/hayleycloud/Downloads/Aegis/src/commands/developers/ban.js", "JavaScript", 79, 0, 10, 89
"/Users/hayleycloud/Downloads/Aegis/src/commands/developers/credits.js", "JavaScript", 67, 0, 10, 77
"/Users/hayleycloud/Downloads/Aegis/src/commands/developers/eval.js", "JavaScript", 88, 0, 14, 102
"/Users/hayleycloud/Downloads/Aegis/src/commands/developers/servers.js", "JavaScript", 9, 0, 4, 13
"/Users/hayleycloud/Downloads/Aegis/src/commands/economy/additem.js", "JavaScript", 42, 0, 12, 54
"/Users/hayleycloud/Downloads/Aegis/src/commands/economy/addmoney.js", "JavaScript", 43, 0, 11, 54
"/Users/hayleycloud/Downloads/Aegis/src/commands/economy/balance.js", "JavaScript", 41, 0, 9, 50
"/Users/hayleycloud/Downloads/Aegis/src/commands/economy/beg.js", "JavaScript", 41, 0, 9, 50
"/Users/hayleycloud/Downloads/Aegis/src/commands/economy/buy.js", "JavaScript", 98, 0, 17, 115
"/Users/hayleycloud/Downloads/Aegis/src/commands/economy/clear.js", "JavaScript", 54, 0, 14, 68
"/Users/hayleycloud/Downloads/Aegis/src/commands/economy/crime.js", "JavaScript", 66, 0, 14, 80
"/Users/hayleycloud/Downloads/Aegis/src/commands/economy/daily.js", "JavaScript", 42, 0, 8, 50
"/Users/hayleycloud/Downloads/Aegis/src/commands/economy/deleteitem.js", "JavaScript", 32, 0, 11, 43
"/Users/hayleycloud/Downloads/Aegis/src/commands/economy/deposit.js", "JavaScript", 32, 0, 11, 43
"/Users/hayleycloud/Downloads/Aegis/src/commands/economy/fish.js", "JavaScript", 62, 0, 18, 80
"/Users/hayleycloud/Downloads/Aegis/src/commands/economy/hourly.js", "JavaScript", 42, 0, 8, 50
"/Users/hayleycloud/Downloads/Aegis/src/commands/economy/hunt.js", "JavaScript", 49, 0, 13, 62
"/Users/hayleycloud/Downloads/Aegis/src/commands/economy/leaderboard.js", "JavaScript", 23, 0, 11, 34
"/Users/hayleycloud/Downloads/Aegis/src/commands/economy/monthly.js", "JavaScript", 42, 0, 8, 50
"/Users/hayleycloud/Downloads/Aegis/src/commands/economy/pay.js", "JavaScript", 41, 0, 12, 53
"/Users/hayleycloud/Downloads/Aegis/src/commands/economy/present.js", "JavaScript", 42, 0, 9, 51
"/Users/hayleycloud/Downloads/Aegis/src/commands/economy/removemoney.js", "JavaScript", 43, 0, 11, 54
"/Users/hayleycloud/Downloads/Aegis/src/commands/economy/rob.js", "JavaScript", 79, 0, 15, 94
"/Users/hayleycloud/Downloads/Aegis/src/commands/economy/store.js", "JavaScript", 20, 0, 6, 26
"/Users/hayleycloud/Downloads/Aegis/src/commands/economy/weekly.js", "JavaScript", 42, 0, 8, 50
"/Users/hayleycloud/Downloads/Aegis/src/commands/economy/withdraw.js", "JavaScript", 32, 0, 11, 43
"/Users/hayleycloud/Downloads/Aegis/src/commands/economy/work.js", "JavaScript", 50, 0, 10, 60
"/Users/hayleycloud/Downloads/Aegis/src/commands/economy/yearly.js", "JavaScript", 46, 0, 8, 54
"/Users/hayleycloud/Downloads/Aegis/src/commands/fun/ascii.js", "JavaScript", 16, 0, 7, 23
"/Users/hayleycloud/Downloads/Aegis/src/commands/fun/birdfact.js", "JavaScript", 15, 0, 4, 19
"/Users/hayleycloud/Downloads/Aegis/src/commands/fun/catfact.js", "JavaScript", 15, 0, 4, 19
"/Users/hayleycloud/Downloads/Aegis/src/commands/fun/cleverrate.js", "JavaScript", 8, 0, 5, 13
"/Users/hayleycloud/Downloads/Aegis/src/commands/fun/confused.js", "JavaScript", 7, 0, 4, 11
"/Users/hayleycloud/Downloads/Aegis/src/commands/fun/dinochrome.js", "JavaScript", 75, 0, 21, 96
"/Users/hayleycloud/Downloads/Aegis/src/commands/fun/dogfact.js", "JavaScript", 15, 0, 4, 19
"/Users/hayleycloud/Downloads/Aegis/src/commands/fun/epicgamerrate.js", "JavaScript", 8, 0, 4, 12
"/Users/hayleycloud/Downloads/Aegis/src/commands/fun/fact.js", "JavaScript", 13, 0, 7, 20
"/Users/hayleycloud/Downloads/Aegis/src/commands/fun/gif.js", "JavaScript", 13, 0, 6, 19
"/Users/hayleycloud/Downloads/Aegis/src/commands/fun/hack.js", "JavaScript", 112, 0, 18, 130
"/Users/hayleycloud/Downloads/Aegis/src/commands/fun/howgay.js", "JavaScript", 12, 0, 4, 16
"/Users/hayleycloud/Downloads/Aegis/src/commands/fun/hug.js", "JavaScript", 18, 0, 7, 25
"/Users/hayleycloud/Downloads/Aegis/src/commands/fun/kill.js", "JavaScript", 197, 0, 8, 205
"/Users/hayleycloud/Downloads/Aegis/src/commands/fun/koalafact.js", "JavaScript", 15, 0, 4, 19
"/Users/hayleycloud/Downloads/Aegis/src/commands/fun/lovemeter.js", "JavaScript", 29, 0, 8, 37
"/Users/hayleycloud/Downloads/Aegis/src/commands/fun/pandafact.js", "JavaScript", 15, 0, 4, 19
"/Users/hayleycloud/Downloads/Aegis/src/commands/fun/reverse.js", "JavaScript", 8, 0, 4, 12
"/Users/hayleycloud/Downloads/Aegis/src/commands/fun/rickroll.js", "JavaScript", 17, 0, 5, 22
"/Users/hayleycloud/Downloads/Aegis/src/commands/fun/roast.js", "JavaScript", 85, 0, 6, 91
"/Users/hayleycloud/Downloads/Aegis/src/commands/fun/say.js", "JavaScript", 14, 0, 5, 19
"/Users/hayleycloud/Downloads/Aegis/src/commands/fun/simprate.js", "JavaScript", 8, 0, 4, 12
"/Users/hayleycloud/Downloads/Aegis/src/commands/fun/stankrate.js", "JavaScript", 8, 0, 4, 12
"/Users/hayleycloud/Downloads/Aegis/src/commands/fun/sudo.js", "JavaScript", 17, 0, 7, 24
"/Users/hayleycloud/Downloads/Aegis/src/commands/fun/token.js", "JavaScript", 15, 0, 6, 21
"/Users/hayleycloud/Downloads/Aegis/src/commands/fun/worldclock.js", "JavaScript", 75, 0, 4, 79
"/Users/hayleycloud/Downloads/Aegis/src/commands/fun/xmas.js", "JavaScript", 15, 0, 3, 18
"/Users/hayleycloud/Downloads/Aegis/src/commands/gambling/blackjack.js", "JavaScript", 306, 0, 21, 327
"/Users/hayleycloud/Downloads/Aegis/src/commands/gambling/crash.js", "JavaScript", 149, 0, 22, 171
"/Users/hayleycloud/Downloads/Aegis/src/commands/gambling/roulette.js", "JavaScript", 49, 0, 17, 66
"/Users/hayleycloud/Downloads/Aegis/src/commands/gambling/slots.js", "JavaScript", 63, 0, 13, 76
"/Users/hayleycloud/Downloads/Aegis/src/commands/games/8ball.js", "JavaScript", 39, 0, 6, 45
"/Users/hayleycloud/Downloads/Aegis/src/commands/games/fasttype.js", "JavaScript", 121, 0, 13, 134
"/Users/hayleycloud/Downloads/Aegis/src/commands/games/music-trivia.js", "JavaScript", 80, 0, 22, 102
"/Users/hayleycloud/Downloads/Aegis/src/commands/games/roll.js", "JavaScript", 9, 0, 4, 13
"/Users/hayleycloud/Downloads/Aegis/src/commands/games/rps.js", "JavaScript", 59, 0, 13, 72
"/Users/hayleycloud/Downloads/Aegis/src/commands/games/skipword.js", "JavaScript", 31, 0, 8, 39
"/Users/hayleycloud/Downloads/Aegis/src/commands/games/snake.js", "JavaScript", 331, 0, 28, 359
"/Users/hayleycloud/Downloads/Aegis/src/commands/games/trivia.js", "JavaScript", 336, 0, 33, 369
"/Users/hayleycloud/Downloads/Aegis/src/commands/games/willyoupressthebutton.js", "JavaScript", 102, 0, 12, 114
"/Users/hayleycloud/Downloads/Aegis/src/commands/games/wouldyourather.js", "JavaScript", 117, 0, 16, 133
"/Users/hayleycloud/Downloads/Aegis/src/commands/giveaway/delete.js", "JavaScript", 18, 0, 3, 21
"/Users/hayleycloud/Downloads/Aegis/src/commands/giveaway/drop.js", "JavaScript", 53, 0, 5, 58
"/Users/hayleycloud/Downloads/Aegis/src/commands/giveaway/edit.js", "JavaScript", 21, 0, 3, 24
"/Users/hayleycloud/Downloads/Aegis/src/commands/giveaway/end.js", "JavaScript", 20, 0, 3, 23
"/Users/hayleycloud/Downloads/Aegis/src/commands/giveaway/pause.js", "JavaScript", 18, 0, 3, 21
"/Users/hayleycloud/Downloads/Aegis/src/commands/giveaway/reroll.js", "JavaScript", 18, 7, 3, 28
"/Users/hayleycloud/Downloads/Aegis/src/commands/giveaway/start.js", "JavaScript", 52, 0, 5, 57
"/Users/hayleycloud/Downloads/Aegis/src/commands/giveaway/unpause.js", "JavaScript", 18, 0, 3, 21
"/Users/hayleycloud/Downloads/Aegis/src/commands/guild/channelinfo.js", "JavaScript", 46, 0, 4, 50
"/Users/hayleycloud/Downloads/Aegis/src/commands/guild/emojis.js", "JavaScript", 40, 0, 7, 47
"/Users/hayleycloud/Downloads/Aegis/src/commands/guild/info.js", "JavaScript", 133, 0, 8, 141
"/Users/hayleycloud/Downloads/Aegis/src/commands/guild/inviteinfo.js", "JavaScript", 101, 0, 10, 111
"/Users/hayleycloud/Downloads/Aegis/src/commands/guild/members.js", "JavaScript", 26, 0, 4, 30
"/Users/hayleycloud/Downloads/Aegis/src/commands/guild/oldestmember.js", "JavaScript", 24, 0, 5, 29
"/Users/hayleycloud/Downloads/Aegis/src/commands/guild/roleinfo.js", "JavaScript", 32, 0, 4, 36
"/Users/hayleycloud/Downloads/Aegis/src/commands/guild/stealemoji.js", "JavaScript", 70, 0, 7, 77
"/Users/hayleycloud/Downloads/Aegis/src/commands/guild/userinfo.js", "JavaScript", 104, 0, 7, 111
"/Users/hayleycloud/Downloads/Aegis/src/commands/guild/youngestmember.js", "JavaScript", 24, 0, 5, 29
"/Users/hayleycloud/Downloads/Aegis/src/commands/images/ad.js", "JavaScript", 10, 0, 5, 15
"/Users/hayleycloud/Downloads/Aegis/src/commands/images/avatar.js", "JavaScript", 8, 0, 4, 12
"/Users/hayleycloud/Downloads/Aegis/src/commands/images/banner.js", "JavaScript", 39, 0, 7, 46
"/Users/hayleycloud/Downloads/Aegis/src/commands/images/bed.js", "JavaScript", 10, 0, 7, 17
"/Users/hayleycloud/Downloads/Aegis/src/commands/images/bird.js", "JavaScript", 15, 0, 4, 19
"/Users/hayleycloud/Downloads/Aegis/src/commands/images/blur.js", "JavaScript", 11, 0, 8, 19
"/Users/hayleycloud/Downloads/Aegis/src/commands/images/burn.js", "JavaScript", 11, 0, 8, 19
"/Users/hayleycloud/Downloads/Aegis/src/commands/images/car.js", "JavaScript", 8, 0, 3, 11
"/Users/hayleycloud/Downloads/Aegis/src/commands/images/cat.js", "JavaScript", 15, 0, 5, 20
"/Users/hayleycloud/Downloads/Aegis/src/commands/images/clown.js", "JavaScript", 10, 0, 7, 17
"/Users/hayleycloud/Downloads/Aegis/src/commands/images/clyde.js", "JavaScript", 9, 0, 6, 15
"/Users/hayleycloud/Downloads/Aegis/src/commands/images/colorify.js", "JavaScript", 10, 0, 7, 17
"/Users/hayleycloud/Downloads/Aegis/src/commands/images/darkness.js", "JavaScript", 11, 0, 8, 19
"/Users/hayleycloud/Downloads/Aegis/src/commands/images/dog.js", "JavaScript", 15, 0, 4, 19
"/Users/hayleycloud/Downloads/Aegis/src/commands/images/drake.js", "JavaScript", 10, 0, 6, 16
"/Users/hayleycloud/Downloads/Aegis/src/commands/images/facepalm.js", "JavaScript", 10, 0, 7, 17
"/Users/hayleycloud/Downloads/Aegis/src/commands/images/fox.js", "JavaScript", 15, 0, 4, 19
"/Users/hayleycloud/Downloads/Aegis/src/commands/images/glass.js", "JavaScript", 7, 0, 3, 10
"/Users/hayleycloud/Downloads/Aegis/src/commands/images/greyscale.js", "JavaScript", 11, 0, 6, 17
"/Users/hayleycloud/Downloads/Aegis/src/commands/images/image.js", "JavaScript", 12, 0, 7, 19
"/Users/hayleycloud/Downloads/Aegis/src/commands/images/invert.js", "JavaScript", 10, 0, 6, 16
"/Users/hayleycloud/Downloads/Aegis/src/commands/images/kiss.js", "JavaScript", 13, 0, 5, 18
"/Users/hayleycloud/Downloads/Aegis/src/commands/images/koala.js", "JavaScript", 15, 0, 4, 19
"/Users/hayleycloud/Downloads/Aegis/src/commands/images/meme.js", "JavaScript", 15, 0, 1, 16
"/Users/hayleycloud/Downloads/Aegis/src/commands/images/panda.js", "JavaScript", 15, 0, 4, 19
"/Users/hayleycloud/Downloads/Aegis/src/commands/images/podium.js", "JavaScript", 14, 0, 5, 19
"/Users/hayleycloud/Downloads/Aegis/src/commands/images/pooh.js", "JavaScript", 10, 0, 6, 16
"/Users/hayleycloud/Downloads/Aegis/src/commands/images/redpanda.js", "JavaScript", 15, 0, 4, 19
"/Users/hayleycloud/Downloads/Aegis/src/commands/images/spank.js", "JavaScript", 11, 0, 5, 16
"/Users/hayleycloud/Downloads/Aegis/src/commands/images/triggered.js", "JavaScript", 7, 0, 3, 10
"/Users/hayleycloud/Downloads/Aegis/src/commands/images/trumptweet.js", "JavaScript", 12, 0, 8, 20
"/Users/hayleycloud/Downloads/Aegis/src/commands/images/tweet.js", "JavaScript", 17, 0, 9, 26
"/Users/hayleycloud/Downloads/Aegis/src/commands/images/wallpaper.js", "JavaScript", 5, 1, 4, 10
"/Users/hayleycloud/Downloads/Aegis/src/commands/images/wanted.js", "JavaScript", 10, 0, 4, 14
"/Users/hayleycloud/Downloads/Aegis/src/commands/images/wasted.js", "JavaScript", 8, 0, 4, 12
"/Users/hayleycloud/Downloads/Aegis/src/commands/invites/add.js", "JavaScript", 37, 0, 8, 45
"/Users/hayleycloud/Downloads/Aegis/src/commands/invites/leaderboard.js", "JavaScript", 11, 0, 7, 18
"/Users/hayleycloud/Downloads/Aegis/src/commands/invites/remove.js", "JavaScript", 34, 0, 8, 42
"/Users/hayleycloud/Downloads/Aegis/src/commands/invites/show.js", "JavaScript", 45, 0, 5, 50
"/Users/hayleycloud/Downloads/Aegis/src/commands/levels/createreward.js", "JavaScript", 37, 0, 8, 45
"/Users/hayleycloud/Downloads/Aegis/src/commands/levels/deletereward.js", "JavaScript", 33, 0, 7, 40
"/Users/hayleycloud/Downloads/Aegis/src/commands/levels/leaderboard.js", "JavaScript", 11, 0, 7, 18
"/Users/hayleycloud/Downloads/Aegis/src/commands/levels/rank.js", "JavaScript", 37, 0, 7, 44
"/Users/hayleycloud/Downloads/Aegis/src/commands/levels/rewards.js", "JavaScript", 11, 0, 7, 18
"/Users/hayleycloud/Downloads/Aegis/src/commands/levels/setlevel.js", "JavaScript", 39, 0, 9, 48
"/Users/hayleycloud/Downloads/Aegis/src/commands/levels/setxp.js", "JavaScript", 39, 0, 9, 48
"/Users/hayleycloud/Downloads/Aegis/src/commands/messages/add.js", "JavaScript", 34, 0, 8, 42
"/Users/hayleycloud/Downloads/Aegis/src/commands/messages/createreward.js", "JavaScript", 37, 0, 8, 45
"/Users/hayleycloud/Downloads/Aegis/src/commands/messages/deletereward.js", "JavaScript", 33, 0, 7, 40
"/Users/hayleycloud/Downloads/Aegis/src/commands/messages/leaderboard.js", "JavaScript", 11, 0, 7, 18
"/Users/hayleycloud/Downloads/Aegis/src/commands/messages/remove.js", "JavaScript", 33, 0, 8, 41
"/Users/hayleycloud/Downloads/Aegis/src/commands/messages/rewards.js", "JavaScript", 11, 0, 7, 18
"/Users/hayleycloud/Downloads/Aegis/src/commands/messages/show.js", "JavaScript", 21, 0, 5, 26
"/Users/hayleycloud/Downloads/Aegis/src/commands/moderation/ban.js", "JavaScript", 54, 0, 7, 61
"/Users/hayleycloud/Downloads/Aegis/src/commands/moderation/banlist.js", "JavaScript", 18, 0, 7, 25
"/Users/hayleycloud/Downloads/Aegis/src/commands/moderation/clear.js", "JavaScript", 35, 0, 8, 43
"/Users/hayleycloud/Downloads/Aegis/src/commands/moderation/clearuser.js", "JavaScript", 50, 0, 7, 57
"/Users/hayleycloud/Downloads/Aegis/src/commands/moderation/demote.js", "JavaScript", 37, 0, 7, 44
"/Users/hayleycloud/Downloads/Aegis/src/commands/moderation/kick.js", "JavaScript", 54, 0, 7, 61
"/Users/hayleycloud/Downloads/Aegis/src/commands/moderation/lock.js", "JavaScript", 22, 0, 7, 29
"/Users/hayleycloud/Downloads/Aegis/src/commands/moderation/lockdown.js", "JavaScript", 19, 0, 6, 25
"/Users/hayleycloud/Downloads/Aegis/src/commands/moderation/nuke.js", "JavaScript", 17, 0, 6, 23
"/Users/hayleycloud/Downloads/Aegis/src/commands/moderation/softban.js", "JavaScript", 57, 0, 8, 65
"/Users/hayleycloud/Downloads/Aegis/src/commands/moderation/tempban.js", "JavaScript", 69, 0, 14, 83
"/Users/hayleycloud/Downloads/Aegis/src/commands/moderation/timeout.js", "JavaScript", 32, 0, 7, 39
"/Users/hayleycloud/Downloads/Aegis/src/commands/moderation/unban.js", "JavaScript", 27, 0, 5, 32
"/Users/hayleycloud/Downloads/Aegis/src/commands/moderation/unlock.js", "JavaScript", 22, 0, 7, 29
"/Users/hayleycloud/Downloads/Aegis/src/commands/moderation/unwarn.js", "JavaScript", 54, 0, 9, 63
"/Users/hayleycloud/Downloads/Aegis/src/commands/moderation/warn.js", "JavaScript", 94, 0, 8, 102
"/Users/hayleycloud/Downloads/Aegis/src/commands/moderation/warnings.js", "JavaScript", 47, 0, 8, 55
"/Users/hayleycloud/Downloads/Aegis/src/commands/music/bassboost.js", "JavaScript", 34, 0, 11, 45
"/Users/hayleycloud/Downloads/Aegis/src/commands/music/clear.js", "JavaScript", 26, 0, 9, 35
"/Users/hayleycloud/Downloads/Aegis/src/commands/music/loop.js", "JavaScript", 23, 0, 8, 31
"/Users/hayleycloud/Downloads/Aegis/src/commands/music/lyrics.js", "JavaScript", 37, 0, 11, 48
"/Users/hayleycloud/Downloads/Aegis/src/commands/music/pause.js", "JavaScript", 22, 0, 8, 30
"/Users/hayleycloud/Downloads/Aegis/src/commands/music/play.js", "JavaScript", 208, 0, 34, 242
"/Users/hayleycloud/Downloads/Aegis/src/commands/music/playing.js", "JavaScript", 78, 0, 13, 91
"/Users/hayleycloud/Downloads/Aegis/src/commands/music/previous.js", "JavaScript", 63, 0, 13, 76
"/Users/hayleycloud/Downloads/Aegis/src/commands/music/queue.js", "JavaScript", 42, 0, 10, 52
"/Users/hayleycloud/Downloads/Aegis/src/commands/music/remove.js", "JavaScript", 28, 0, 11, 39
"/Users/hayleycloud/Downloads/Aegis/src/commands/music/resume.js", "JavaScript", 22, 0, 8, 30
"/Users/hayleycloud/Downloads/Aegis/src/commands/music/seek.js", "JavaScript", 74, 0, 15, 89
"/Users/hayleycloud/Downloads/Aegis/src/commands/music/shuffle.js", "JavaScript", 26, 0, 9, 35
"/Users/hayleycloud/Downloads/Aegis/src/commands/music/skip.js", "JavaScript", 22, 0, 8, 30
"/Users/hayleycloud/Downloads/Aegis/src/commands/music/skipto.js", "JavaScript", 23, 0, 9, 32
"/Users/hayleycloud/Downloads/Aegis/src/commands/music/stop.js", "JavaScript", 22, 0, 8, 30
"/Users/hayleycloud/Downloads/Aegis/src/commands/music/volume.js", "JavaScript", 35, 0, 12, 47
"/Users/hayleycloud/Downloads/Aegis/src/commands/notepad/add.js", "JavaScript", 23, 0, 8, 31
"/Users/hayleycloud/Downloads/Aegis/src/commands/notepad/delete.js", "JavaScript", 16, 0, 6, 22
"/Users/hayleycloud/Downloads/Aegis/src/commands/notepad/edit.js", "JavaScript", 16, 0, 6, 22
"/Users/hayleycloud/Downloads/Aegis/src/commands/notepad/notes.js", "JavaScript", 9, 0, 7, 16
"/Users/hayleycloud/Downloads/Aegis/src/commands/profile/aboutme.js", "JavaScript", 23, 0, 7, 30
"/Users/hayleycloud/Downloads/Aegis/src/commands/profile/addactor.js", "JavaScript", 31, 0, 7, 38
"/Users/hayleycloud/Downloads/Aegis/src/commands/profile/addartist.js", "JavaScript", 31, 0, 7, 38
"/Users/hayleycloud/Downloads/Aegis/src/commands/profile/addfood.js", "JavaScript", 31, 0, 7, 38
"/Users/hayleycloud/Downloads/Aegis/src/commands/profile/addhobby.js", "JavaScript", 31, 0, 7, 38
"/Users/hayleycloud/Downloads/Aegis/src/commands/profile/addmovie.js", "JavaScript", 31, 0, 7, 38
"/Users/hayleycloud/Downloads/Aegis/src/commands/profile/addpet.js", "JavaScript", 31, 0, 7, 38
"/Users/hayleycloud/Downloads/Aegis/src/commands/profile/addsong.js", "JavaScript", 31, 0, 7, 38
"/Users/hayleycloud/Downloads/Aegis/src/commands/profile/age.js", "JavaScript", 23, 0, 7, 30
"/Users/hayleycloud/Downloads/Aegis/src/commands/profile/bday.js", "JavaScript", 33, 0, 12, 45
"/Users/hayleycloud/Downloads/Aegis/src/commands/profile/color.js", "JavaScript", 24, 0, 7, 31
"/Users/hayleycloud/Downloads/Aegis/src/commands/profile/create.js", "JavaScript", 14, 0, 4, 18
"/Users/hayleycloud/Downloads/Aegis/src/commands/profile/delactor.js", "JavaScript", 30, 0, 9, 39
"/Users/hayleycloud/Downloads/Aegis/src/commands/profile/delartist.js", "JavaScript", 30, 0, 9, 39
"/Users/hayleycloud/Downloads/Aegis/src/commands/profile/delete.js", "JavaScript", 19, 0, 5, 24
"/Users/hayleycloud/Downloads/Aegis/src/commands/profile/delfood.js", "JavaScript", 30, 0, 9, 39
"/Users/hayleycloud/Downloads/Aegis/src/commands/profile/delhobby.js", "JavaScript", 30, 0, 9, 39
"/Users/hayleycloud/Downloads/Aegis/src/commands/profile/delmovie.js", "JavaScript", 30, 0, 9, 39
"/Users/hayleycloud/Downloads/Aegis/src/commands/profile/delpet.js", "JavaScript", 30, 0, 9, 39
"/Users/hayleycloud/Downloads/Aegis/src/commands/profile/delsong.js", "JavaScript", 30, 0, 9, 39
"/Users/hayleycloud/Downloads/Aegis/src/commands/profile/gender.js", "JavaScript", 51, 0, 8, 59
"/Users/hayleycloud/Downloads/Aegis/src/commands/profile/origin.js", "JavaScript", 23, 0, 7, 30
"/Users/hayleycloud/Downloads/Aegis/src/commands/profile/profile.js", "JavaScript", 166, 0, 12, 178
"/Users/hayleycloud/Downloads/Aegis/src/commands/profile/status.js", "JavaScript", 23, 0, 7, 30
"/Users/hayleycloud/Downloads/Aegis/src/commands/radio/play.js", "JavaScript", 58, 0, 8, 66
"/Users/hayleycloud/Downloads/Aegis/src/commands/radio/playing.js", "JavaScript", 24, 0, 3, 27
"/Users/hayleycloud/Downloads/Aegis/src/commands/radio/stop.js", "JavaScript", 42, 0, 8, 50
"/Users/hayleycloud/Downloads/Aegis/src/commands/reactionroles/add.js", "JavaScript", 56, 0, 8, 64
"/Users/hayleycloud/Downloads/Aegis/src/commands/reactionroles/button.js", "JavaScript", 33, 0, 11, 44
"/Users/hayleycloud/Downloads/Aegis/src/commands/reactionroles/delete.js", "JavaScript", 16, 0, 7, 23
"/Users/hayleycloud/Downloads/Aegis/src/commands/reactionroles/list.js", "JavaScript", 18, 0, 7, 25
"/Users/hayleycloud/Downloads/Aegis/src/commands/reactionroles/menu.js", "JavaScript", 58, 0, 17, 75
"/Users/hayleycloud/Downloads/Aegis/src/commands/search/bing.js", "JavaScript", 15, 0, 6, 21
"/Users/hayleycloud/Downloads/Aegis/src/commands/search/corona.js", "JavaScript", 33, 0, 8, 41
"/Users/hayleycloud/Downloads/Aegis/src/commands/search/crypto.js", "JavaScript", 23, 0, 7, 30
"/Users/hayleycloud/Downloads/Aegis/src/commands/search/ddg.js", "JavaScript", 15, 0, 6, 21
"/Users/hayleycloud/Downloads/Aegis/src/commands/search/docs.js", "JavaScript", 20, 0, 7, 27
"/Users/hayleycloud/Downloads/Aegis/src/commands/search/github.js", "JavaScript", 43, 0, 7, 50
"/Users/hayleycloud/Downloads/Aegis/src/commands/search/google.js", "JavaScript", 15, 0, 6, 21
"/Users/hayleycloud/Downloads/Aegis/src/commands/search/hexcolour.js", "JavaScript", 31, 0, 6, 37
"/Users/hayleycloud/Downloads/Aegis/src/commands/search/itunes.js", "JavaScript", 54, 0, 6, 60
"/Users/hayleycloud/Downloads/Aegis/src/commands/search/npm.js", "JavaScript", 52, 0, 6, 58
"/Users/hayleycloud/Downloads/Aegis/src/commands/search/steam.js", "JavaScript", 44, 0, 6, 50
"/Users/hayleycloud/Downloads/Aegis/src/commands/search/translate.js", "JavaScript", 31, 0, 6, 37
"/Users/hayleycloud/Downloads/Aegis/src/commands/search/weather.js", "JavaScript", 51, 0, 6, 57
"/Users/hayleycloud/Downloads/Aegis/src/commands/search/youtube.js", "JavaScript", 15, 0, 6, 21
"/Users/hayleycloud/Downloads/Aegis/src/commands/serverstats/animated-emoji.js", "JavaScript", 50, 0, 9, 59
"/Users/hayleycloud/Downloads/Aegis/src/commands/serverstats/boosts.js", "JavaScript", 39, 0, 7, 46
"/Users/hayleycloud/Downloads/Aegis/src/commands/serverstats/bots.js", "JavaScript", 40, 0, 8, 48
"/Users/hayleycloud/Downloads/Aegis/src/commands/serverstats/channels.js", "JavaScript", 39, 0, 7, 46
"/Users/hayleycloud/Downloads/Aegis/src/commands/serverstats/emoji.js", "JavaScript", 39, 0, 7, 46
"/Users/hayleycloud/Downloads/Aegis/src/commands/serverstats/members.js", "JavaScript", 39, 0, 7, 46
"/Users/hayleycloud/Downloads/Aegis/src/commands/serverstats/news-channels.js", "JavaScript", 39, 0, 7, 46
"/Users/hayleycloud/Downloads/Aegis/src/commands/serverstats/roles.js", "JavaScript", 39, 0, 7, 46
"/Users/hayleycloud/Downloads/Aegis/src/commands/serverstats/stage-channels.js", "JavaScript", 39, 0, 7, 46
"/Users/hayleycloud/Downloads/Aegis/src/commands/serverstats/static-emoji.js", "JavaScript", 54, 0, 10, 64
"/Users/hayleycloud/Downloads/Aegis/src/commands/serverstats/text-channels.js", "JavaScript", 39, 0, 7, 46
"/Users/hayleycloud/Downloads/Aegis/src/commands/serverstats/tier.js", "JavaScript", 45, 0, 8, 53
"/Users/hayleycloud/Downloads/Aegis/src/commands/serverstats/time.js", "JavaScript", 40, 0, 10, 50
"/Users/hayleycloud/Downloads/Aegis/src/commands/serverstats/voice-channels.js", "JavaScript", 39, 0, 7, 46
"/Users/hayleycloud/Downloads/Aegis/src/commands/setup/customvoice.js", "JavaScript", 44, 0, 6, 50
"/Users/hayleycloud/Downloads/Aegis/src/commands/setup/deletesetup.js", "JavaScript", 44, 0, 6, 50
"/Users/hayleycloud/Downloads/Aegis/src/commands/setup/fun.js", "JavaScript", 18, 0, 7, 25
"/Users/hayleycloud/Downloads/Aegis/src/commands/setup/games.js", "JavaScript", 41, 0, 12, 53
"/Users/hayleycloud/Downloads/Aegis/src/commands/setup/logs.js", "JavaScript", 14, 0, 7, 21
"/Users/hayleycloud/Downloads/Aegis/src/commands/setup/ticketpanel.js", "JavaScript", 33, 0, 8, 41
"/Users/hayleycloud/Downloads/Aegis/src/commands/setup/tickets.js", "JavaScript", 30, 0, 6, 36
"/Users/hayleycloud/Downloads/Aegis/src/commands/setup/welcomechannels.js", "JavaScript", 12, 0, 7, 19
"/Users/hayleycloud/Downloads/Aegis/src/commands/setup/welcomerole.js", "JavaScript", 6, 0, 5, 11
"/Users/hayleycloud/Downloads/Aegis/src/commands/soundboard/dancememe.js", "JavaScript", 6, 0, 5, 11
"/Users/hayleycloud/Downloads/Aegis/src/commands/soundboard/defaultdance.js", "JavaScript", 6, 0, 5, 11
"/Users/hayleycloud/Downloads/Aegis/src/commands/soundboard/despacito.js", "JavaScript", 6, 0, 5, 11
"/Users/hayleycloud/Downloads/Aegis/src/commands/soundboard/discordcall.js", "JavaScript", 6, 0, 5, 11
"/Users/hayleycloud/Downloads/Aegis/src/commands/soundboard/discordjoin.js", "JavaScript", 6, 0, 5, 11
"/Users/hayleycloud/Downloads/Aegis/src/commands/soundboard/discordleave.js", "JavaScript", 6, 0, 5, 11
"/Users/hayleycloud/Downloads/Aegis/src/commands/soundboard/discordnotification.js", "JavaScript", 6, 0, 5, 11
"/Users/hayleycloud/Downloads/Aegis/src/commands/soundboard/elevator.js", "JavaScript", 6, 0, 5, 11
"/Users/hayleycloud/Downloads/Aegis/src/commands/soundboard/fbi.js", "JavaScript", 6, 0, 5, 11
"/Users/hayleycloud/Downloads/Aegis/src/commands/soundboard/jeff.js", "JavaScript", 6, 0, 5, 11
"/Users/hayleycloud/Downloads/Aegis/src/commands/soundboard/lambo.js", "JavaScript", 6, 0, 5, 11
"/Users/hayleycloud/Downloads/Aegis/src/commands/soundboard/missionfailed.js", "JavaScript", 6, 0, 5, 11
"/Users/hayleycloud/Downloads/Aegis/src/commands/soundboard/moaning.js", "JavaScript", 6, 0, 5, 11
"/Users/hayleycloud/Downloads/Aegis/src/commands/soundboard/nani.js", "JavaScript", 6, 0, 5, 11
"/Users/hayleycloud/Downloads/Aegis/src/commands/soundboard/nyancat.js", "JavaScript", 6, 0, 5, 11
"/Users/hayleycloud/Downloads/Aegis/src/commands/soundboard/ohh.js", "JavaScript", 6, 0, 5, 11
"/Users/hayleycloud/Downloads/Aegis/src/commands/soundboard/reee.js", "JavaScript", 6, 0, 5, 11
"/Users/hayleycloud/Downloads/Aegis/src/commands/soundboard/rickastley.js", "JavaScript", 6, 0, 5, 11
"/Users/hayleycloud/Downloads/Aegis/src/commands/soundboard/rimshot.js", "JavaScript", 6, 0, 5, 11
"/Users/hayleycloud/Downloads/Aegis/src/commands/soundboard/roblox.js", "JavaScript", 6, 0, 5, 11
"/Users/hayleycloud/Downloads/Aegis/src/commands/soundboard/running.js", "JavaScript", 6, 0, 5, 11
"/Users/hayleycloud/Downloads/Aegis/src/commands/soundboard/shotdown.js", "JavaScript", 6, 0, 5, 11
"/Users/hayleycloud/Downloads/Aegis/src/commands/soundboard/spongebob.js", "JavaScript", 6, 0, 5, 11
"/Users/hayleycloud/Downloads/Aegis/src/commands/soundboard/startup.js", "JavaScript", 6, 0, 5, 11
"/Users/hayleycloud/Downloads/Aegis/src/commands/soundboard/thomas.js", "JavaScript", 6, 0, 5, 11
"/Users/hayleycloud/Downloads/Aegis/src/commands/soundboard/tobecontinued.js", "JavaScript", 6, 0, 5, 11
"/Users/hayleycloud/Downloads/Aegis/src/commands/soundboard/wegothim.js", "JavaScript", 6, 0, 5, 11
"/Users/hayleycloud/Downloads/Aegis/src/commands/soundboard/windowserror.js", "JavaScript", 6, 0, 5, 11
"/Users/hayleycloud/Downloads/Aegis/src/commands/soundboard/windowsshutdown.js", "JavaScript", 6, 0, 5, 11
"/Users/hayleycloud/Downloads/Aegis/src/commands/soundboard/windowsstartup.js", "JavaScript", 6, 0, 5, 11
"/Users/hayleycloud/Downloads/Aegis/src/commands/soundboard/wow.js", "JavaScript", 6, 0, 5, 11
"/Users/hayleycloud/Downloads/Aegis/src/commands/soundboard/yeet.js", "JavaScript", 6, 0, 5, 11
"/Users/hayleycloud/Downloads/Aegis/src/commands/stickymessages/messages.js", "JavaScript", 22, 0, 7, 29
"/Users/hayleycloud/Downloads/Aegis/src/commands/stickymessages/stick.js", "JavaScript", 37, 0, 6, 43
"/Users/hayleycloud/Downloads/Aegis/src/commands/stickymessages/unstick.js", "JavaScript", 27, 0, 5, 32
"/Users/hayleycloud/Downloads/Aegis/src/commands/suggestions/accept.js", "JavaScript", 58, 0, 11, 69
"/Users/hayleycloud/Downloads/Aegis/src/commands/suggestions/deny.js", "JavaScript", 58, 0, 11, 69
"/Users/hayleycloud/Downloads/Aegis/src/commands/suggestions/send.js", "JavaScript", 47, 0, 7, 54
"/Users/hayleycloud/Downloads/Aegis/src/commands/thanks/check.js", "JavaScript", 13, 0, 9, 22
"/Users/hayleycloud/Downloads/Aegis/src/commands/thanks/thanks.js", "JavaScript", 34, 0, 8, 42
"/Users/hayleycloud/Downloads/Aegis/src/commands/tickets/add.js", "JavaScript", 33, 0, 9, 42
"/Users/hayleycloud/Downloads/Aegis/src/commands/tickets/claim.js", "JavaScript", 61, 0, 13, 74
"/Users/hayleycloud/Downloads/Aegis/src/commands/tickets/close.js", "JavaScript", 135, 0, 19, 154
"/Users/hayleycloud/Downloads/Aegis/src/commands/tickets/create.js", "JavaScript", 197, 0, 23, 220
"/Users/hayleycloud/Downloads/Aegis/src/commands/tickets/delete.js", "JavaScript", 48, 0, 9, 57
"/Users/hayleycloud/Downloads/Aegis/src/commands/tickets/information.js", "JavaScript", 71, 0, 10, 81
"/Users/hayleycloud/Downloads/Aegis/src/commands/tickets/lower.js", "JavaScript", 55, 0, 12, 67
"/Users/hayleycloud/Downloads/Aegis/src/commands/tickets/notice.js", "JavaScript", 54, 0, 10, 64
"/Users/hayleycloud/Downloads/Aegis/src/commands/tickets/open.js", "JavaScript", 62, 0, 14, 76
"/Users/hayleycloud/Downloads/Aegis/src/commands/tickets/raise.js", "JavaScript", 55, 0, 12, 67
"/Users/hayleycloud/Downloads/Aegis/src/commands/tickets/remove.js", "JavaScript", 41, 0, 10, 51
"/Users/hayleycloud/Downloads/Aegis/src/commands/tickets/rename.js", "JavaScript", 33, 0, 9, 42
"/Users/hayleycloud/Downloads/Aegis/src/commands/tickets/transcript.js", "JavaScript", 52, 0, 12, 64
"/Users/hayleycloud/Downloads/Aegis/src/commands/tickets/unclaim.js", "JavaScript", 61, 0, 12, 73
"/Users/hayleycloud/Downloads/Aegis/src/commands/tools/anagram.js", "JavaScript", 24, 0, 8, 32
"/Users/hayleycloud/Downloads/Aegis/src/commands/tools/button.js", "JavaScript", 18, 0, 9, 27
"/Users/hayleycloud/Downloads/Aegis/src/commands/tools/calculator.js", "JavaScript", 200, 0, 19, 219
"/Users/hayleycloud/Downloads/Aegis/src/commands/tools/decode.js", "JavaScript", 28, 0, 8, 36
"/Users/hayleycloud/Downloads/Aegis/src/commands/tools/emojify.js", "JavaScript", 35, 0, 9, 44
"/Users/hayleycloud/Downloads/Aegis/src/commands/tools/encode.js", "JavaScript", 22, 0, 7, 29
"/Users/hayleycloud/Downloads/Aegis/src/commands/tools/enlarge.js", "JavaScript", 15, 0, 6, 21
"/Users/hayleycloud/Downloads/Aegis/src/commands/tools/mcskin.js", "JavaScript", 10, 0, 7, 17
"/Users/hayleycloud/Downloads/Aegis/src/commands/tools/mcstatus.js", "JavaScript", 31, 0, 8, 39
"/Users/hayleycloud/Downloads/Aegis/src/commands/tools/pwdgen.js", "JavaScript", 25, 0, 7, 32
"/Users/hayleycloud/Downloads/Aegis/src/commands/tools/qrcode.js", "JavaScript", 9, 0, 6, 15
"/Users/hayleycloud/Downloads/Aegis/src/commands/tools/remind.js", "JavaScript", 44, 0, 10, 54
"/Users/hayleycloud/Downloads/Aegis/src/commands/tools/review.js", "JavaScript", 61, 0, 10, 71
"/Users/hayleycloud/Downloads/Aegis/src/commands/tools/sourcebin.js", "JavaScript", 30, 0, 6, 36
"/Users/hayleycloud/Downloads/Aegis/src/commands/tools/url.js", "JavaScript", 23, 0, 6, 29
"/Users/hayleycloud/Downloads/Aegis/src/commands/unfinished/adopt.js", "JavaScript", 100, 0, 19, 119
"/Users/hayleycloud/Downloads/Aegis/src/commands/unfinished/delete.js", "JavaScript", 47, 0, 14, 61
"/Users/hayleycloud/Downloads/Aegis/src/commands/unfinished/disown.js", "JavaScript", 53, 0, 12, 65
"/Users/hayleycloud/Downloads/Aegis/src/commands/unfinished/divorce.js", "JavaScript", 35, 0, 11, 46
"/Users/hayleycloud/Downloads/Aegis/src/commands/unfinished/family.js", "JavaScript", 25, 0, 7, 32
"/Users/hayleycloud/Downloads/Aegis/src/commands/unfinished/propose.js", "JavaScript", 124, 0, 16, 140
"/Users/hayleycloud/Downloads/Aegis/src/commands/voice/limit.js", "JavaScript", 33, 0, 7, 40
"/Users/hayleycloud/Downloads/Aegis/src/commands/voice/lock.js", "JavaScript", 34, 0, 7, 41
"/Users/hayleycloud/Downloads/Aegis/src/commands/voice/rename.js", "JavaScript", 33, 0, 8, 41
"/Users/hayleycloud/Downloads/Aegis/src/commands/voice/unlock.js", "JavaScript", 34, 0, 6, 40
"/Users/hayleycloud/Downloads/Aegis/src/database/connect.js", "JavaScript", 26, 0, 5, 31
"/Users/hayleycloud/Downloads/Aegis/src/database/models/afk.js", "JavaScript", 7, 0, 2, 9
"/Users/hayleycloud/Downloads/Aegis/src/database/models/badge.js", "JavaScript", 6, 0, 2, 8
"/Users/hayleycloud/Downloads/Aegis/src/database/models/birthday.js", "JavaScript", 7, 0, 2, 9
"/Users/hayleycloud/Downloads/Aegis/src/database/models/birthdaychannels.js", "JavaScript", 6, 0, 2, 8
"/Users/hayleycloud/Downloads/Aegis/src/database/models/blacklist.js", "JavaScript", 6, 0, 2, 8
"/Users/hayleycloud/Downloads/Aegis/src/database/models/boostChannels.js", "JavaScript", 6, 0, 2, 8
"/Users/hayleycloud/Downloads/Aegis/src/database/models/boostMessage.js", "JavaScript", 7, 0, 2, 9
"/Users/hayleycloud/Downloads/Aegis/src/database/models/channelList.js", "JavaScript", 6, 0, 2, 8
"/Users/hayleycloud/Downloads/Aegis/src/database/models/chatbot-channel.js", "JavaScript", 6, 0, 2, 8
"/Users/hayleycloud/Downloads/Aegis/src/database/models/count.js", "JavaScript", 7, 0, 2, 9
"/Users/hayleycloud/Downloads/Aegis/src/database/models/countChannel.js", "JavaScript", 7, 0, 2, 9
"/Users/hayleycloud/Downloads/Aegis/src/database/models/customCommand.js", "JavaScript", 7, 0, 2, 9
"/Users/hayleycloud/Downloads/Aegis/src/database/models/customCommandAdvanced.js", "JavaScript", 8, 0, 2, 10
"/Users/hayleycloud/Downloads/Aegis/src/database/models/developers.js", "JavaScript", 6, 0, 2, 8
"/Users/hayleycloud/Downloads/Aegis/src/database/models/economy.js", "JavaScript", 8, 0, 2, 10
"/Users/hayleycloud/Downloads/Aegis/src/database/models/economyItems.js", "JavaScript", 8, 0, 2, 10
"/Users/hayleycloud/Downloads/Aegis/src/database/models/economyStore.js", "JavaScript", 7, 0, 2, 9
"/Users/hayleycloud/Downloads/Aegis/src/database/models/economyTimeout.js", "JavaScript", 18, 0, 2, 20
"/Users/hayleycloud/Downloads/Aegis/src/database/models/family.js", "JavaScript", 9, 0, 2, 11
"/Users/hayleycloud/Downloads/Aegis/src/database/models/functions.js", "JavaScript", 14, 0, 2, 16
"/Users/hayleycloud/Downloads/Aegis/src/database/models/giveaways.js", "JavaScript", 55, 0, 2, 57
"/Users/hayleycloud/Downloads/Aegis/src/database/models/guessNumber.js", "JavaScript", 7, 0, 2, 9
"/Users/hayleycloud/Downloads/Aegis/src/database/models/guessWord.js", "JavaScript", 7, 0, 2, 9
"/Users/hayleycloud/Downloads/Aegis/src/database/models/inviteBy.js", "JavaScript", 7, 0, 2, 9
"/Users/hayleycloud/Downloads/Aegis/src/database/models/inviteMessages.js", "JavaScript", 7, 0, 2, 9
"/Users/hayleycloud/Downloads/Aegis/src/database/models/inviteRewards.js", "JavaScript", 7, 0, 2, 9
"/Users/hayleycloud/Downloads/Aegis/src/database/models/invites.js", "JavaScript", 9, 0, 2, 11
"/Users/hayleycloud/Downloads/Aegis/src/database/models/joinRole.js", "JavaScript", 6, 0, 2, 8
"/Users/hayleycloud/Downloads/Aegis/src/database/models/leaveChannels.js", "JavaScript", 6, 0, 2, 8
"/Users/hayleycloud/Downloads/Aegis/src/database/models/levelChannels.js", "JavaScript", 6, 0, 2, 8
"/Users/hayleycloud/Downloads/Aegis/src/database/models/levelMessages.js", "JavaScript", 6, 0, 2, 8
"/Users/hayleycloud/Downloads/Aegis/src/database/models/levelRewards.js", "JavaScript", 7, 0, 2, 9
"/Users/hayleycloud/Downloads/Aegis/src/database/models/levels.js", "JavaScript", 9, 0, 2, 11
"/Users/hayleycloud/Downloads/Aegis/src/database/models/logChannels.js", "JavaScript", 6, 0, 2, 8
"/Users/hayleycloud/Downloads/Aegis/src/database/models/messageRewards.js", "JavaScript", 7, 0, 2, 9
"/Users/hayleycloud/Downloads/Aegis/src/database/models/messages.js", "JavaScript", 7, 0, 2, 9
"/Users/hayleycloud/Downloads/Aegis/src/database/models/music.js", "JavaScript", 6, 0, 2, 8
"/Users/hayleycloud/Downloads/Aegis/src/database/models/notes.js", "JavaScript", 8, 0, 2, 10
"/Users/hayleycloud/Downloads/Aegis/src/database/models/privatechannels.js", "JavaScript", 8, 0, 2, 10
"/Users/hayleycloud/Downloads/Aegis/src/database/models/profile.js", "JavaScript", 19, 0, 2, 21
"/Users/hayleycloud/Downloads/Aegis/src/database/models/radios.js", "JavaScript", 7, 0, 2, 9
"/Users/hayleycloud/Downloads/Aegis/src/database/models/reactionRoles.js", "JavaScript", 8, 0, 2, 10
"/Users/hayleycloud/Downloads/Aegis/src/database/models/reminder.js", "JavaScript", 7, 0, 2, 9
"/Users/hayleycloud/Downloads/Aegis/src/database/models/reviewChannels.js", "JavaScript", 6, 0, 2, 8
"/Users/hayleycloud/Downloads/Aegis/src/database/models/starboardChannels.js", "JavaScript", 6, 0, 2, 8
"/Users/hayleycloud/Downloads/Aegis/src/database/models/stats.js", "JavaScript", 20, 0, 2, 22
"/Users/hayleycloud/Downloads/Aegis/src/database/models/stickymessages.js", "JavaScript", 8, 0, 2, 10
"/Users/hayleycloud/Downloads/Aegis/src/database/models/suggestionChannels.js", "JavaScript", 6, 0, 2, 8
"/Users/hayleycloud/Downloads/Aegis/src/database/models/tempban.js", "JavaScript", 7, 0, 2, 9
"/Users/hayleycloud/Downloads/Aegis/src/database/models/thanks.js", "JavaScript", 7, 0, 2, 9
"/Users/hayleycloud/Downloads/Aegis/src/database/models/thanksAuthor.js", "JavaScript", 6, 0, 2, 8
"/Users/hayleycloud/Downloads/Aegis/src/database/models/ticketChannels.js", "JavaScript", 10, 0, 2, 12
"/Users/hayleycloud/Downloads/Aegis/src/database/models/ticketMessage.js", "JavaScript", 7, 0, 2, 9
"/Users/hayleycloud/Downloads/Aegis/src/database/models/tickets.js", "JavaScript", 10, 0, 2, 12
"/Users/hayleycloud/Downloads/Aegis/src/database/models/userBans.js", "JavaScript", 5, 0, 2, 7
"/Users/hayleycloud/Downloads/Aegis/src/database/models/verify.js", "JavaScript", 8, 0, 2, 10
"/Users/hayleycloud/Downloads/Aegis/src/database/models/voice.js", "JavaScript", 9, 0, 2, 11
"/Users/hayleycloud/Downloads/Aegis/src/database/models/voiceChannels.js", "JavaScript", 6, 0, 2, 8
"/Users/hayleycloud/Downloads/Aegis/src/database/models/votecredits.js", "JavaScript", 7, 0, 2, 9
"/Users/hayleycloud/Downloads/Aegis/src/database/models/warnCase.js", "JavaScript", 6, 0, 2, 8
"/Users/hayleycloud/Downloads/Aegis/src/database/models/warnings.js", "JavaScript", 7, 0, 2, 9
"/Users/hayleycloud/Downloads/Aegis/src/database/models/welcomeChannels.js", "JavaScript", 6, 0, 2, 8
"/Users/hayleycloud/Downloads/Aegis/src/database/models/wordsnake.js", "JavaScript", 7, 0, 2, 9
"/Users/hayleycloud/Downloads/Aegis/src/dev.js", "JavaScript", 51, 14, 0, 65
"/Users/hayleycloud/Downloads/Aegis/src/events/channel/channelCreate.js", "JavaScript", 43, 0, 3, 46
"/Users/hayleycloud/Downloads/Aegis/src/events/channel/channelDelete.js", "JavaScript", 47, 0, 5, 52
"/Users/hayleycloud/Downloads/Aegis/src/events/channel/channelNameUpdate.js", "JavaScript", 46, 0, 3, 49
"/Users/hayleycloud/Downloads/Aegis/src/events/channel/channelPinsUpdate.js", "JavaScript", 46, 0, 3, 49
"/Users/hayleycloud/Downloads/Aegis/src/events/channel/channelTopicUpdate.js", "JavaScript", 50, 0, 3, 53
"/Users/hayleycloud/Downloads/Aegis/src/events/client/clientReady.js", "JavaScript", 48, 0, 7, 55
"/Users/hayleycloud/Downloads/Aegis/src/events/client/error.js", "JavaScript", 3, 0, 0, 3
"/Users/hayleycloud/Downloads/Aegis/src/events/client/errorCreate.js", "JavaScript", 72, 0, 6, 78
"/Users/hayleycloud/Downloads/Aegis/src/events/client/guildCreate.js", "JavaScript", 87, 0, 11, 98
"/Users/hayleycloud/Downloads/Aegis/src/events/client/guildDelete.js", "JavaScript", 72, 0, 5, 77
"/Users/hayleycloud/Downloads/Aegis/src/events/client/interactionCreate.js", "JavaScript", 185, 6, 31, 222
"/Users/hayleycloud/Downloads/Aegis/src/events/client/raw.js", "JavaScript", 4, 0, 3, 7
"/Users/hayleycloud/Downloads/Aegis/src/events/emoji/emojiCreate.js", "JavaScript", 27, 0, 2, 29
"/Users/hayleycloud/Downloads/Aegis/src/events/emoji/emojiDelete.js", "JavaScript", 19, 0, 2, 21
"/Users/hayleycloud/Downloads/Aegis/src/events/emoji/emojiUpdate.js", "JavaScript", 27, 0, 2, 29
"/Users/hayleycloud/Downloads/Aegis/src/events/event/guildScheduledEventCreate.js", "JavaScript", 49, 0, 4, 53
"/Users/hayleycloud/Downloads/Aegis/src/events/event/guildScheduledEventDelete.js", "JavaScript", 49, 0, 4, 53
"/Users/hayleycloud/Downloads/Aegis/src/events/event/guildScheduledEventUpdate.js", "JavaScript", 43, 0, 2, 45
"/Users/hayleycloud/Downloads/Aegis/src/events/giveaway/endedGiveawayReactionAdded.js", "JavaScript", 6, 0, 1, 7
"/Users/hayleycloud/Downloads/Aegis/src/events/giveaway/giveawayEnded.js", "JavaScript", 21, 0, 2, 23
"/Users/hayleycloud/Downloads/Aegis/src/events/giveaway/giveawayReactionAdded.js", "JavaScript", 6, 0, 1, 7
"/Users/hayleycloud/Downloads/Aegis/src/events/giveaway/giveawayRerolled.js", "JavaScript", 21, 0, 2, 23
"/Users/hayleycloud/Downloads/Aegis/src/events/guild/guildAfkChannelAdd.js", "JavaScript", 27, 0, 2, 29
"/Users/hayleycloud/Downloads/Aegis/src/events/guild/guildBanAdd.js", "JavaScript", 28, 0, 2, 30
"/Users/hayleycloud/Downloads/Aegis/src/events/guild/guildBanRemove.js", "JavaScript", 28, 0, 2, 30
"/Users/hayleycloud/Downloads/Aegis/src/events/guild/guildBannerAdd.js", "JavaScript", 10, 0, 2, 12
"/Users/hayleycloud/Downloads/Aegis/src/events/guild/guildBoostLevelDown.js", "JavaScript", 23, 0, 2, 25
"/Users/hayleycloud/Downloads/Aegis/src/events/guild/guildBoostLevelUp.js", "JavaScript", 23, 0, 2, 25
"/Users/hayleycloud/Downloads/Aegis/src/events/guild/guildMemberAdd.js", "JavaScript", 10, 0, 3, 13
"/Users/hayleycloud/Downloads/Aegis/src/events/guild/guildMemberBoost.js", "JavaScript", 49, 0, 11, 60
"/Users/hayleycloud/Downloads/Aegis/src/events/guild/guildMemberRemove.js", "JavaScript", 76, 0, 19, 95
"/Users/hayleycloud/Downloads/Aegis/src/events/guild/guildMemberUnboost.js", "JavaScript", 49, 0, 13, 62
"/Users/hayleycloud/Downloads/Aegis/src/events/guild/guildMemberUpdate.js", "JavaScript", 28, 7, 4, 39
"/Users/hayleycloud/Downloads/Aegis/src/events/guild/guildVanityURLAdd.js", "JavaScript", 19, 0, 2, 21
"/Users/hayleycloud/Downloads/Aegis/src/events/invite/inviteCreate.js", "JavaScript", 23, 0, 2, 25
"/Users/hayleycloud/Downloads/Aegis/src/events/invite/inviteDelete.js", "JavaScript", 19, 0, 2, 21
"/Users/hayleycloud/Downloads/Aegis/src/events/invite/inviteJoin.js", "JavaScript", 155, 0, 30, 185
"/Users/hayleycloud/Downloads/Aegis/src/events/message/messageCreate.js", "JavaScript", 385, 12, 39, 436
"/Users/hayleycloud/Downloads/Aegis/src/events/message/messageDelete.js", "JavaScript", 39, 0, 5, 44
"/Users/hayleycloud/Downloads/Aegis/src/events/message/messageReactionAdd.js", "JavaScript", 93, 0, 13, 106
"/Users/hayleycloud/Downloads/Aegis/src/events/message/messageReactionRemove.js", "JavaScript", 61, 0, 12, 73
"/Users/hayleycloud/Downloads/Aegis/src/events/message/messageUpdate.js", "JavaScript", 50, 0, 5, 55
"/Users/hayleycloud/Downloads/Aegis/src/events/music/nodeConnect.js", "JavaScript", 5, 0, 1, 6
"/Users/hayleycloud/Downloads/Aegis/src/events/music/nodeError.js", "JavaScript", 5, 0, 1, 6
"/Users/hayleycloud/Downloads/Aegis/src/events/music/playerDisconnect.js", "JavaScript", 9, 0, 2, 11
"/Users/hayleycloud/Downloads/Aegis/src/events/music/playerMove.js", "JavaScript", 18, 0, 2, 20
"/Users/hayleycloud/Downloads/Aegis/src/events/music/queueEnd.js", "JavaScript", 8, 0, 2, 10
"/Users/hayleycloud/Downloads/Aegis/src/events/music/trackStart.js", "JavaScript", 47, 0, 6, 53
"/Users/hayleycloud/Downloads/Aegis/src/events/role/roleColorUpdate.js", "JavaScript", 31, 0, 2, 33
"/Users/hayleycloud/Downloads/Aegis/src/events/role/roleCreate.js", "JavaScript", 35, 0, 3, 38
"/Users/hayleycloud/Downloads/Aegis/src/events/role/roleDelete.js", "JavaScript", 35, 0, 2, 37
"/Users/hayleycloud/Downloads/Aegis/src/events/role/roleNameUpdate.js", "JavaScript", 31, 0, 2, 33
"/Users/hayleycloud/Downloads/Aegis/src/events/role/rolePermissionsUpdate.js", "JavaScript", 31, 0, 3, 34
"/Users/hayleycloud/Downloads/Aegis/src/events/stats/updateAEmojis.js", "JavaScript", 24, 0, 6, 30
"/Users/hayleycloud/Downloads/Aegis/src/events/stats/updateBoosts.js", "JavaScript", 13, 0, 3, 16
"/Users/hayleycloud/Downloads/Aegis/src/events/stats/updateBots.js", "JavaScript", 14, 0, 4, 18
"/Users/hayleycloud/Downloads/Aegis/src/events/stats/updateChannels.js", "JavaScript", 13, 0, 3, 16
"/Users/hayleycloud/Downloads/Aegis/src/events/stats/updateClock.js", "JavaScript", 27, 0, 5, 32
"/Users/hayleycloud/Downloads/Aegis/src/events/stats/updateEmojis.js", "JavaScript", 13, 0, 3, 16
"/Users/hayleycloud/Downloads/Aegis/src/events/stats/updateMembers.js", "JavaScript", 13, 0, 3, 16
"/Users/hayleycloud/Downloads/Aegis/src/events/stats/updateNewsChannels.js", "JavaScript", 15, 0, 3, 18
"/Users/hayleycloud/Downloads/Aegis/src/events/stats/updateRoles.js", "JavaScript", 13, 0, 3, 16
"/Users/hayleycloud/Downloads/Aegis/src/events/stats/updateSEmojis.js", "JavaScript", 24, 0, 6, 30
"/Users/hayleycloud/Downloads/Aegis/src/events/stats/updateStageChannels.js", "JavaScript", 15, 0, 3, 18
"/Users/hayleycloud/Downloads/Aegis/src/events/stats/updateTextChannels.js", "JavaScript", 15, 0, 3, 18
"/Users/hayleycloud/Downloads/Aegis/src/events/stats/updateTier.js", "JavaScript", 19, 0, 4, 23
"/Users/hayleycloud/Downloads/Aegis/src/events/stats/updateVoiceChannels.js", "JavaScript", 15, 0, 3, 18
"/Users/hayleycloud/Downloads/Aegis/src/events/sticker/stickerCreate.js", "JavaScript", 23, 0, 2, 25
"/Users/hayleycloud/Downloads/Aegis/src/events/sticker/stickerDelete.js", "JavaScript", 19, 0, 2, 21
"/Users/hayleycloud/Downloads/Aegis/src/events/sticker/stickerUpdate.js", "JavaScript", 23, 0, 2, 25
"/Users/hayleycloud/Downloads/Aegis/src/events/thread/threadCreate.js", "JavaScript", 36, 0, 3, 39
"/Users/hayleycloud/Downloads/Aegis/src/events/thread/threadDelete.js", "JavaScript", 32, 0, 3, 35
"/Users/hayleycloud/Downloads/Aegis/src/events/thread/threadUpdate.js", "JavaScript", 40, 0, 3, 43
"/Users/hayleycloud/Downloads/Aegis/src/events/voice/voiceError.js", "JavaScript", 22, 0, 3, 25
"/Users/hayleycloud/Downloads/Aegis/src/events/voice/voiceStateUpdate.js", "JavaScript", 122, 0, 16, 138
"/Users/hayleycloud/Downloads/Aegis/src/events/warn/warnAdd.js", "JavaScript", 33, 7, 2, 42
"/Users/hayleycloud/Downloads/Aegis/src/events/warn/warnRemove.js", "JavaScript", 27, 0, 2, 29
"/Users/hayleycloud/Downloads/Aegis/src/handlers/audio/music.js", "JavaScript", 193, 0, 42, 235
"/Users/hayleycloud/Downloads/Aegis/src/handlers/audio/radio.js", "JavaScript", 76, 0, 20, 96
"/Users/hayleycloud/Downloads/Aegis/src/handlers/components/button.js", "JavaScript", 60, 0, 18, 78
"/Users/hayleycloud/Downloads/Aegis/src/handlers/components/customEvents.js", "JavaScript", 67, 0, 18, 85
"/Users/hayleycloud/Downloads/Aegis/src/handlers/components/embed.js", "JavaScript", 269, 21, 31, 321
"/Users/hayleycloud/Downloads/Aegis/src/handlers/components/select.js", "JavaScript", 102, 0, 28, 130
"/Users/hayleycloud/Downloads/Aegis/src/handlers/functions/birthdays.js", "JavaScript", 69, 0, 19, 88
"/Users/hayleycloud/Downloads/Aegis/src/handlers/functions/databaseFunctions.js", "JavaScript", 50, 0, 3, 53
"/Users/hayleycloud/Downloads/Aegis/src/handlers/functions/functions.js", "JavaScript", 204, 4, 37, 245
"/Users/hayleycloud/Downloads/Aegis/src/handlers/functions/giveaway.js", "JavaScript", 40, 0, 10, 50
"/Users/hayleycloud/Downloads/Aegis/src/handlers/functions/inviteTracker.js", "JavaScript", 62, 0, 13, 75
"/Users/hayleycloud/Downloads/Aegis/src/handlers/functions/serverstats.js", "JavaScript", 57, 0, 11, 68
"/Users/hayleycloud/Downloads/Aegis/src/handlers/functions/soundboard.js", "JavaScript", 36, 0, 13, 49
"/Users/hayleycloud/Downloads/Aegis/src/handlers/functions/ticket.js", "JavaScript", 369, 22, 117, 508
"/Users/hayleycloud/Downloads/Aegis/src/handlers/games/counting.js", "JavaScript", 125, 0, 17, 142
"/Users/hayleycloud/Downloads/Aegis/src/handlers/games/economy.js", "JavaScript", 48, 0, 5, 53
"/Users/hayleycloud/Downloads/Aegis/src/handlers/games/guessNumber.js", "JavaScript", 47, 0, 8, 55
"/Users/hayleycloud/Downloads/Aegis/src/handlers/games/guessWord.js", "JavaScript", 50, 0, 9, 59
"/Users/hayleycloud/Downloads/Aegis/src/handlers/games/levels.js", "JavaScript", 67, 0, 25, 92
"/Users/hayleycloud/Downloads/Aegis/src/handlers/games/wordsnake.js", "JavaScript", 35, 0, 9, 44
"/Users/hayleycloud/Downloads/Aegis/src/handlers/helppanel/changelogs.js", "JavaScript", 62, 0, 6, 68
"/Users/hayleycloud/Downloads/Aegis/src/handlers/helppanel/commands.js", "JavaScript", 287, 0, 14, 301
"/Users/hayleycloud/Downloads/Aegis/src/handlers/helppanel/invite.js", "JavaScript", 62, 0, 8, 70
"/Users/hayleycloud/Downloads/Aegis/src/handlers/helppanel/support.js", "JavaScript", 58, 0, 7, 65
"/Users/hayleycloud/Downloads/Aegis/src/handlers/linkspanel/botInvite.js", "JavaScript", 58, 0, 7, 65
"/Users/hayleycloud/Downloads/Aegis/src/handlers/linkspanel/communityServer.js", "JavaScript", 58, 0, 8, 66
"/Users/hayleycloud/Downloads/Aegis/src/handlers/linkspanel/supportServer.js", "JavaScript", 58, 0, 7, 65
"/Users/hayleycloud/Downloads/Aegis/src/handlers/linkspanel/topGG.js", "JavaScript", 58, 0, 8, 66
"/Users/hayleycloud/Downloads/Aegis/src/handlers/loaders/commands.js", "JavaScript", 48, 0, 13, 61
"/Users/hayleycloud/Downloads/Aegis/src/handlers/loaders/event.js", "JavaScript", 22, 0, 7, 29
"/Users/hayleycloud/Downloads/Aegis/src/handlers/security/antiad.js", "JavaScript", 173, 0, 17, 190
"/Users/hayleycloud/Downloads/Aegis/src/handlers/security/antispam.js", "JavaScript", 57, 0, 6, 63
"/Users/hayleycloud/Downloads/Aegis/src/handlers/security/blacklist.js", "JavaScript", 48, 0, 10, 58
"/Users/hayleycloud/Downloads/Aegis/src/handlers/security/tempban.js", "JavaScript", 24, 0, 8, 32
"/Users/hayleycloud/Downloads/Aegis/src/index.js", "JavaScript", 176, 3, 19, 198
"/Users/hayleycloud/Downloads/Aegis/src/interactions/Command/activities.js", "JavaScript", 76, 5, 7, 88
"/Users/hayleycloud/Downloads/Aegis/src/interactions/Command/afk.js", "JavaScript", 30, 5, 6, 41
"/Users/hayleycloud/Downloads/Aegis/src/interactions/Command/announcement.js", "JavaScript", 37, 5, 7, 49
"/Users/hayleycloud/Downloads/Aegis/src/interactions/Command/automod.js", "JavaScript", 79, 5, 7, 91
"/Users/hayleycloud/Downloads/Aegis/src/interactions/Command/autosetup.js", "JavaScript", 96, 5, 7, 108
"/Users/hayleycloud/Downloads/Aegis/src/interactions/Command/birthdays.js", "JavaScript", 40, 5, 5, 50
"/Users/hayleycloud/Downloads/Aegis/src/interactions/Command/bot.js", "JavaScript", 73, 5, 5, 83
"/Users/hayleycloud/Downloads/Aegis/src/interactions/Command/casino.js", "JavaScript", 43, 5, 5, 53
"/Users/hayleycloud/Downloads/Aegis/src/interactions/Command/commands.js", "JavaScript", 37, 5, 8, 50
"/Users/hayleycloud/Downloads/Aegis/src/interactions/Command/config.js", "JavaScript", 78, 5, 5, 88
"/Users/hayleycloud/Downloads/Aegis/src/interactions/Command/developers.js", "JavaScript", 89, 5, 6, 100
"/Users/hayleycloud/Downloads/Aegis/src/interactions/Command/economy.js", "JavaScript", 160, 5, 7, 172
"/Users/hayleycloud/Downloads/Aegis/src/interactions/Command/embed.js", "JavaScript", 335, 5, 32, 372
"/Users/hayleycloud/Downloads/Aegis/src/interactions/Command/family.js", "JavaScript", 53, 5, 6, 64
"/Users/hayleycloud/Downloads/Aegis/src/interactions/Command/fun.js", "JavaScript", 184, 9, 13, 206
"/Users/hayleycloud/Downloads/Aegis/src/interactions/Command/games.js", "JavaScript", 79, 5, 5, 89
"/Users/hayleycloud/Downloads/Aegis/src/interactions/Command/giveaway.js", "JavaScript", 78, 5, 7, 90
"/Users/hayleycloud/Downloads/Aegis/src/interactions/Command/guild.js", "JavaScript", 74, 5, 5, 84
"/Users/hayleycloud/Downloads/Aegis/src/interactions/Command/help.js", "JavaScript", 66, 5, 6, 77
"/Users/hayleycloud/Downloads/Aegis/src/interactions/Command/images.js", "JavaScript", 258, 9, 19, 286
"/Users/hayleycloud/Downloads/Aegis/src/interactions/Command/invite.js", "JavaScript", 30, 5, 7, 42
"/Users/hayleycloud/Downloads/Aegis/src/interactions/Command/invites.js", "JavaScript", 43, 5, 5, 53
"/Users/hayleycloud/Downloads/Aegis/src/interactions/Command/levels.js", "JavaScript", 67, 5, 6, 78
"/Users/hayleycloud/Downloads/Aegis/src/interactions/Command/message.js", "JavaScript", 363, 82, 22, 467
"/Users/hayleycloud/Downloads/Aegis/src/interactions/Command/messages.js", "JavaScript", 61, 5, 5, 71
"/Users/hayleycloud/Downloads/Aegis/src/interactions/Command/moderation.js", "JavaScript", 127, 5, 5, 137
"/Users/hayleycloud/Downloads/Aegis/src/interactions/Command/music.js", "JavaScript", 123, 5, 7, 135
"/Users/hayleycloud/Downloads/Aegis/src/interactions/Command/notepad.js", "JavaScript", 42, 5, 5, 52
"/Users/hayleycloud/Downloads/Aegis/src/interactions/Command/profile.js", "JavaScript", 190, 5, 8, 203
"/Users/hayleycloud/Downloads/Aegis/src/interactions/Command/radio.js", "JavaScript", 41, 5, 7, 53
"/Users/hayleycloud/Downloads/Aegis/src/interactions/Command/reactionroles.js", "JavaScript", 57, 5, 7, 69
"/Users/hayleycloud/Downloads/Aegis/src/interactions/Command/report.js", "JavaScript", 68, 5, 9, 82
"/Users/hayleycloud/Downloads/Aegis/src/interactions/Command/search.js", "JavaScript", 104, 5, 5, 114
"/Users/hayleycloud/Downloads/Aegis/src/interactions/Command/serverstats.js", "JavaScript", 98, 5, 7, 110
"/Users/hayleycloud/Downloads/Aegis/src/interactions/Command/setup.js", "JavaScript", 147, 5, 7, 159
"/Users/hayleycloud/Downloads/Aegis/src/interactions/Command/soundboard.js", "JavaScript", 199, 11, 18, 228
"/Users/hayleycloud/Downloads/Aegis/src/interactions/Command/stickymessages.js", "JavaScript", 42, 5, 7, 54
"/Users/hayleycloud/Downloads/Aegis/src/interactions/Command/suggestions.js", "JavaScript", 36, 5, 5, 46
"/Users/hayleycloud/Downloads/Aegis/src/interactions/Command/thanks.js", "JavaScript", 30, 5, 5, 40
"/Users/hayleycloud/Downloads/Aegis/src/interactions/Command/tickets.js", "JavaScript", 94, 5, 6, 105
"/Users/hayleycloud/Downloads/Aegis/src/interactions/Command/tools.js", "JavaScript", 111, 5, 6, 122
"/Users/hayleycloud/Downloads/Aegis/src/interactions/Command/voice.js", "JavaScript", 40, 5, 5, 50
"/Users/hayleycloud/Downloads/Aegis/src/interactions/ContextMenu/profile.js", "JavaScript", 175, 5, 15, 195
"/Users/hayleycloud/Downloads/Aegis/src/interactions/ContextMenu/unwarn.js", "JavaScript", 83, 11, 9, 103
"/Users/hayleycloud/Downloads/Aegis/src/interactions/ContextMenu/userinfo.js", "JavaScript", 112, 5, 9, 126
"/Users/hayleycloud/Downloads/Aegis/src/interactions/ContextMenu/warn.js", "JavaScript", 121, 6, 11, 138
"/Users/hayleycloud/Downloads/Aegis/src/interactions/ContextMenu/warnings.js", "JavaScript", 55, 5, 8, 68
"Total", "-", 26291, 458, 4507, 31256